3,0,3,0,3,
0,4,1,4,0,
3,1,2,1,3,
0,4,1,4,0,
3,0,3,0,3,